.P....|.F.@|....@.
.{>...[>. <]...<}.
.|@ ^. ......^.@|.
.[>.v.<---->.v.<].
..................
