.P..........|.F.@|
............[>..<]
--}..<----->......
..v............^..
...............|.@
