. ..........|.F.@|
............[>..<]
--}..<-> <->......
..v..........<-}..
.P.....  ......|.@
