. .|...@|.........
...  ..<].........
--}....<> .<>.....
..[-->.....<-}@@@@
.P.....  ....|.F@@
